S.......1..1...
...............
...........1...
.......1.......
...............
1........1.....
....1..........
...............
..1............
...............
...............
...........1...
...............
..........F....
...........1...